0000001110000000001100000
0000111110000000011111100
0001111110000000001111110
0001111000000000000111010
0000110000000000000000000
0000000000000000000000000
1100000000000000000000000
1000000000000000000111100
1100000011010100000111100
1100000011111100000111100
1100000011111100000011100
1000000000111000000011000
1100000000111000000000000
0000000000000000000000000
0000000000000011000000000
0000000000000011100011100
0011100000001111100011000
0011100000001111100111000
0011110000001111101111000
0011111000011111101111000
0001110000011111111111000
0001110000000101111011100
0000000000000000000000000
0000000000000000000000000
0000000000000000000000000