0011100000000000000000000
0011100000000000011100000
0111000000000000011101000
0110000000000000011111000
0000000000000000001111000
0000000000000000001110000
0000000000000000001000000
0000001110000000000000000
0001111110000000000000000
0001111111100000000000000
0000111111100000000000000
0000000111100000000000000
0000000001110000000000000
0000000011110000000110000
0000000111110000000111000
0111010111110000111111000
0111111111110000111111000
0111111111100000101111100
0001110111100000000011000
0000000101100000000000000
0000000000000000000000000
0000000000000000000000000
0000000000000011000000000
0000000000000011110000000
0000000000000011100000000