0000000000000000000001100
0111110000000000000111110
0111100000000000000111110
0111110000000000000111111
0011100000000000000000111
0010000000000000000000111
0000000000010111110000111
0000000000011111110000011
0000000011111111110000011
0000000001111111110000001
0000000001111111110000011
0000000000001111000000000
0001110000011101000000000
0001110000000000000000000
0000111000000000000000000
0000111000000000000000000
0011111110000000011100000
0011111110000000001110000
0001111110000011111110000
0000111110001111111110000
0000111100011111111110000
0000101000011111111110000
0000000000000101011110000
0000000000000000000000000
0000000000000000000000000