0011100000000000000000000
0011111000000000000000000
0000111110000000000000000
0000111111100001110000000
0001111011100001110000000
0001110011100001110011110
0101100011100000111111110
0111000001100001111111110
0111000001100011111000000
0111100011100011111000000
0111100001100011111100000
0011110000000001111100000
0001110000000011111110000
0001010000000111111110000
0000000000001111101010000
0000000111001100000000000
0000000110000000000000000
0000000111000000000000000
0000001111111000000000000
0000001111111000011000000
0000001111111011111110000
0000000111111111111110000
0000000011111110101100000
0000000001101110000000000
0000000000000000000000000
