0000000000000000000000000
1110000000000000000011100
1110000000000000001111110
1110111000000000001111110
0000011000000001111111110
0000111000000000111111100
0000000011100001111111111
0000000001100000011111111
0000000011100000001111111
0000000011100000001111110
0000000011100000001111110
0000000000000000000111110
0000000000000000000111000
0000000000111000000111000
0000000000011000000000000
0000000001111000000000000
0000000101110000000000000
0000000111111000000000000
0000000111111111000000000
0000000000111111000000000
0000000000011111000000000
0000000000000100000000000
0000000000000000000000000
0000000000000000000000000
0000000000000000000000000